R	832 832
SO	./settings/pics/eagle.xpm
NO	./settings/pics/redbrick.xpm
WE	./settings/pics/wood.xpm	
EA	./settings/pics/colorstone.xpm

S	./settings/pics/colorstone.xpm
F	243,114,32
C 	43,250,250

11111
10001111111111
10S01111111001
10001111111111
11111



