R	832 832
SO	./settings/pics/eagle.xpm
NO	./settings/pics/wood.xpm
WE	./settings/pics/redbrick.xpm
EA	./settings/pics/colorstone.xpm
S	./settings/pics/barrel.xpm
F	243,114,32
C	43,250,250

1111111111111
1			1
1	 111	1
1	10001	1
1  1002001	1
1 100000001	1
1 100020001	1
1 1000N0001	1
1  1002001	1
1	10001	1
1	 111	1
1			1
1111111111111