R	832	832
NO	./settings/pics/eagle.xpm
SO	./settings/pics/wood.xpm
WE	./settings/pics/redbrick.xpm
EA	./settings/pics/colorstone.xpm
S	./settings/pics/barrel.xpm
F	243,114,32
C	43,250,250

1111111111111
1000000000001
1000000000001
1000000000001
1000100010001
1000000000001
100000E000001
1000000000001
1000100010001
1000000000001
1000000000001
1000000000001
1111111111111