      				R	1920	1080

NO	./settings/pics/eagle.xpm
SO	./settings/pics/wood.xpm
WE	./settings/pics/redbrick.xpm
EA	./settings/pics/colorstone.xpm

S	./settings/pics/barrel.xpm

F	243,114,32

C	43,250,250






1111111111111
1100000000001
1010000000001
1001000000001
1000100000001
1000010000001
100000N000001
1000000100001
1000000010001
1000000001001
1000000000101
1000000000011
1111111111111
